原樹理	b
森唯斗	b
高橋礼	b
三上朋也	b
上林誠知	b
中村奨吾	b
京田陽太	b
今永昇太	b
吉川尚輝	b
吉田正尚	b
大城滉二	b
大山悠輔	b
小林誠司	b
山岡泰輔	b
山本由伸	b
山﨑康晃	b
岡本和真	b
村上宗隆	b
松永昂大	b
梅野雄吾	b
森原康平	b
田口麗斗	b
田村龍弘	b
甲斐拓也	b
西川遥輝	b
近藤健介	b
野間峻祥	b
乾貴士	f
堂安律	f
室屋成	f
山口蛍	f
昌子源	f
柴崎岳	f
西大伍	f
三浦弦太	f
中島翔哉	f
中村航輔	f
佐々木翔	f
冨安健洋	f
南野拓実	f
安西幸輝	f
小林祐希	f
東口順昭	f
橋本拳人	f
鈴木武蔵	f
鎌田大地	f
香川真司	f
宇佐美貴史	f
シュミット・ダニエル	f
上田仁	t
佐藤瞳	t
水谷隼	t
丹羽孝希	t
伊藤美誠	t
加藤美優	t
吉村真晴	t
大島祐哉	t
平野美宇	t
張本智和	t
早田ひな	t
木原美悠	t
松平健太	t
森さくら	t
森薗政崇	t
石川佳純	t
長﨑美柚	t
橋本帆乃香	t
李博	v
宮下遥	v
黒後愛	v
井上琴絵	v
今村優香	v
佐藤美弥	v
入澤まい	v
大竹壱青	v
奥村麻依	v
小幡真子	v
岩坂名奈	v
島村春世	v
新鍋理沙	v
柳田将洋	v
深津旭弘	v
深津英臣	v
清水邦広	v
石井優希	v
石川祐希	v
福澤達哉	v
芥川愛加	v
藤井直伸	v
西田有志	v
内瀬戸真実	v
冨永こよみ	v
古賀紗理那	v
小野寺太志	v
山岸あかね	v
東谷玲衣奈	v
田代佳奈美	v
荒木絵里香	v
鍋谷友理枝	v
長内美和子	v
